# @(#)TimeTool.properties	1.5 05/12/23
#
# Resource strings for TimeTool 

Title=TimeTool

fileLabel=File
reloadLabel=Reload
saveLabel=Save
exportLabel=Export to CSV...
optionsLabel=Options
quitLabel=Quit

timetoolLabel=TimeTool
stopLabel=Stop the Clock
adjustLabel=Adjust Time
resetLabel=Reset All Times
addLabel=Add Task
deleteLabel=Delete Task
renameLabel=Rename Task

helpLabel=Help
helpfileLabel=Help
readmeLabel=View TimeTool.txt...
licenseLabel=View License.txt...
homepageLabel=Home Page...
supportLabel=Contact Support...
aboutLabel=About...

quitTooltip=Quit TimeTool (Ctrl+Q)
stopTooltip=Stop the Clock (Ctrl+E)
adjustTooltip=Adjust Time (Ctrl+T)
resetTooltip=Reset All Times to Zero (Ctrl+R)
addTooltip=Add Task (Ctrl+A)
deleteTooltip=Delete Task (Ctrl+D)
renameTooltip=Rename Task (Ctrl+N)
exportTooltip=Export to CSV
aboutTooltip=Display About Dialog

#
# Language Labels
#
# main window
GridTaskHeader=Task
GridDescHeader=Description
GridMinsHeader=Minutes
GridHourHeader=Hours

NoActiveTask=No Active Task
ConfirmResetTitle=Confirm Reset
ConfirmReset=Are you sure you want to reset all the tasks?
ConfirmDeleteTitle=Confirm Delete
ConfirmDelete=Are you sure you want to delete the selected task?
AdjustTitle=Adjust Time
AdjustMessage=Adjustment (+ or -): 
AboutTitle=About TimeTool
AboutMessage=TimeTool\nJava Based Version 1.0\n\nTimeTool is free software distributed under the terms of the GNU GPL

# add task dialog
AddTaskTitleMessage=Add a Task
DescriptionLabelMessage=Description:
TaskLabelMessage=Task ID:

# rename task dialog
RenameTaskTitleMessage=Rename a Task
#DescriptionLabelMessage=Description:
#TaskLabelMessage=Task ID:

# csv options dialog
CSVOptionsTitleMessage=CSV Options
CSVQuoteLabelMessage=Quotes (default double quote):
CSVDecimalLabelMessage=Decimal (default period):
CSVDelimiterLabelMessage=Delimiter (default comma):
HoursHeader = HOURS
MinutesHeader = MINUTES
ProjNameHeader = PROJNAME
ProjNumHeader = PROJNUM

# error messages
BrowserError1=Could not find web browser
BrowserError2=Error attempting to launch web browser
UncaughtException=uncaught exception:
GenericError=Error
InformationTitle=Information
NumericOnly=Entry must be numeric
NoTaskSelected=You must first select the task you want to adjust

# common button labels
OKLabel=OK
CancelLabel=Cancel


